11111111111111111111111111111111111111111111111111
100S00010000000C10000C00S000000001C000000010000001
101001C1001000001010010000C00101000111110000S001C1
10100111101S10100010111001111101S11P11C1S000001101
1E0000000C00C000000000000100C000010000000001110001
1010010111100000101C010000000101000111110000C00111
100001000000S00C000S010S00000000010000S00010000001
1C00S1000C0000S100000000010SS000C10S000000C1111101
1110000000111C010S000111000C00001000000C0010000001
11111111111111111111111111111111111111111111111111