1111111111111111111111111111111111
1E0S00000000000C000S0C000000000001
1010010100100S00101001000000S10101
101001001010101S001001000S00010101
1P00S0000CS0C0000000000000000000C1
1111111111111111111111111111111111