11111111111111111111111111111111111111111111111111
100000010000000C10000C000000000001C000000010000001
101001C1001000001010010000C001010001111100000001C1
10100111101010100010111001111101011P11C10000001101
1E0000000C00C000000000000100C000010000000001110001
1010010111100000101C010000000101000111110000C00111
100001000000000C0000010000000000010000000010000001
1C0001000C00C0010000000001000000C100000000C1111101
111000000011100100000111000C00001000000C0010000001
11111111111111111111111111111111111111111111111111